//HaskellParser.dll
%PREFIX%=HaskellPARSER_

EXPECTED{0}=ќжидалось {0}
EXPECTED_{0}_BUT_FOUND_{1}=ќжидалось '{0}', а встречено '{1}'
NONTERMINALTOKEN_{0}_RETURN_NULL=Cинтаксическа€ конструкци€ вида '{0}' не поддерживаетс€ текущей версией парсера

EOF=(конец файла)
TKIDENTIFIER=идентификатор
TKNUMBER=число
OPERATOR=оператор
TKSEMICOLON=';'
TKDOUBLEPOINT=':'
TKASSIGN='='
TKEQUAL='=='
TKROUNDOPEN='('
TKROUNDCLOSE=')'
TKSQUAREOPEN='['
TKSQUARECLOSE=']'
TKFIGUREOPEN='{'
TKFIGURECLOSE=' }'

tkNewLine=переход_на_новую_строку
tkIdentifier=идентификатор
tkinteger=целое_число
tkreal=вещественное_число
tkchar=символ
tkString=строка
tkboolean=логическое_значение
tkvar=рез
tkprint=вывод
tkif=если
tkthen=то
tkelse=иначе
tkcase=выбор
tknot=не
tkand=и
tkor=или
tkwhile=пока
tkfor=дл€
tkfrom=от
tkto=до
tkColon=':'
tkSemiColon=';'
tkComma=','
tkEqual='=='
tkGreater='>'
tkGreaterEqual='>='
tkLower='<'
tkLowerEqual='<='
tkNotEqual='<>'
tkMinus='-'
tkPlus='+'
tkDiv='/'
tkMult='*'
tkAssign='='


EXPRESSION=выражение
Expression=выражение
STATEMENT=оператор
Statement=оператор

ONE_EOF=ќжидалс€ конец файла
ONE_TKIDENTIFIER=ќжидалс€ идентификатор
ONE_OPERATOR=ќжидалс€ оператор
ONE_STMT=ќжидалс€ оператор